###############
#X.=========.X#
#.#=#=#=#=#=#.#
#=============#
#=#=#=#=#=#=#=#
#=============#
#=#=#=#=#=#=#=#
#=============#
#=#=#=#=#=#=#=#
#=============#
#.#=#=#=#=#=#.#
#X.=========.X#
###############