###############
#.............#
#.#.....#.#.#.#
#.............#
#.#...#.#.#.#.#
#.............#
#.#.#.#.#.#.#.#
#.............#
#.#.#.#.#.#.#.#
#.............#
#.#.#.#.#.#.#.#
#.............#
###############