###############
#..=========..#
#.#=#=#=#=#=#.#
#=============#
#=#=#=#=#=#=#=#
#=============#
#=#=#=#=#=#=#=#
#=============#
#=#=#=#=#=#=#=#
#=============#
#.#=#=#=#=#=#.#
#..=========..#
###############