###############################
#v#.#...#...#.#.#...#.#.#...#.#
#.#.#.#.###.#.#.#.###.#.###.#.#
#.....#.#.......#.#.#...#...#.#
#.#.#######.#.#.#.#.###.###.#.#
#.#.....#.#.#.#...#...#.......#
#.###.###.###.###.#.#####.###.#
#.#.#.#...#.#.#.......#.#.#.#.#
###.#.###.#.#######.###.###.#.#
#.........#.....#.#.......#...#
#####.#.###.#####.#######.###.#
#.....#.......#.#...#.#...#...#
###.###.#####.#.###.#.###.#.#.#
#.#.#...#.....#.#.........#.#.#
#.###########.#.#########.###.#
#.............#.#.........#.#.#
#######.###.#.#.#########.#.#.#
#...#...#...#.#.....#.#...#...#
###.#########.###.###.###.###.#
#.....#...#.........#.........#
#####.#.###.#.#.#.###########.#
#...........#.#.#.........#.#.#
#######.#####.###.###.###.#.#.#
#.....#.#.....#...#.#.#.......#
###.#.###.#######.#.#####.#.#.#
#...#.....#.....#.#...#...#.#.#
#######.#######.#####.#.###.#.#
#.#.#.#.#...........#...#...#.#
#.#.#.###########.#.#######.#.#
#.................#.........#F#
###############################