#############################################
#v..........#......#.....#............#.#...#
###########.######...###.####.###.#.###.###.#
#....#...........###.#......#.......#.....#.#
##.#.#.#.###.#.#...#.#.####.#######.###.#.#.#
#..#.#.#.#.#.#########..#.........#...#.#.#.#
##.#.#.#...#...........####.##.####.#...###.#
#..#.#....####.#######.#....#.......#.#.#...#
##.#.#..#.#....#.#.....######.#######.#.#.#.#
#..#......#.####...#.###....#..#..#...###.#.#
##.########.#....###.#.#.#####.##.#.#.....#.#
#......#.##.######.#.#.#.......#..#########.#
##..#..#...............#######.##...........#
#......#.###############.#.###.#...########.#
####...#.#...#....#..#.......#.######.....#.#
##.#.###.#.#.####......##.##.#......##..#.#.#
#....#.#...#.#..#.####.#...#.#.####.##.####.#
#.####.#####.#.##....#.##.##.#.##.#..#.#..#.#
#.#.#..#.#.###.#..#..#.#...#.#..#......#.##.#
#...#.##.#.....#.##.##.#######.#########..#.#
#.###.##.#######..#..#.........#.......##.#.#
#.#....#.......#.###############.###...#..#.#
#.###.########...............#.....###.##.#.#
###.........##.#############.#.###...#..#.#.#
#............#..#....#.#...#.#.#...#.##.#.#.#
#.#.........#####.#.##.#.#.#.#.##########.#.#
#.#...............#.#..#.#.#.#.#....#...#.#.#
#.#.#.#.#.#.#######.##.#.#.#.#.##.#.#.###.#.#
#.#.#.#.#.#.#.....#....#.#...#..#.###...#.#.#
#.#.#.#.###.#.###.#.####.#.#.#..#.....#.#.#.#
#.#.....#...#...#.#..#...#.#.#.########.#.#.#
#.#.###.###.##.##.##.##.##.#.#.#.#...F#.#.#.#
#.#...#.....#..#...#.##.#..#.#.#...####.#...#
#.###.#####...###..#....#....#.###..#.#.#.#.#
#.#.......###.#...##.#..######.#.#......#.#.#
#.#.#####...#.###.#..#...........####.#.#.#.#
#.#..#....#.#...#.#######.####.#....#.#.#...#
#.###########.#.#..#...##.##.#.####.#...###.#
#.#........#..#.#.##.#.#..#..#.#..#.###...#.#
#.##.#####.#..#.#.#..#...##.##.##.#...###.#.#
#.#..#.#...#..#.#.#########.#####.#..##...#.#
#.##.#.#.#.#..#......................#..###.#
#.##.#.#.#.###########################.##...#
#....#...#.............................#....#
#############################################