###############
#..=======.=..#
#.#=#=#=#=#=#.#
#==.=====.====#
#=#.#=#.#.#=#=#
#=====.=======#
#=#.#.#=#=#.#.#
#.===..===.=.=#
#=#=#.#=#=#=#=#
#=....========#
#.#=#=#=#=#=#.#
#..=========..#
###############